also remove image=Supprimer également l'image
Apply=Appliquer
Are you sure=Êtes-vous sûr
Cancel=Annuler
checking=Vérification en cours
Completely REMOVE=SUPPRIMER complètement
Console=Console
day=jour
days=jours
disk image and definition=image du disque et définition
Disks=Disques
Donate=Faire un don
Done=Terminé
Edit=Modifier
Execution error=Erreur d'exécution
Force Stop=Forcer l'arrêt
Hibernate=Mettre en veille
Log for=Journal pour
log=journal
Logs=Journaux
More Info=Plus d'informations
No=Non
OK=OK
Ok=Ok
Pause=Pause
Proceed=Poursuivre
Project Page=Page du projet
Read Me First=Lisez-moi d'abord
Remove container=Supprimer le conteneur
Remove definition=Supprimer la définition
Remove image=Supprimer l'image
Remove VM=Supprimer la machine virtuelle
Remove=Supprimer
Restart=Redémarrer
Resume=Reprendre
Start=Démarrer
Stop=Arrêter
Support=Support
Update container=Mise à jour du conteneur
Update=Mise à jour
Updating all Containers=Mise à jour de tous les conteneurs
Updating the container=Mise à jour du conteneur
VNC Remote=Accès distant VNC
WebUI=WebUI
Yes, delete it=Oui, supprimez-le !
Yes, update it=Oui, mettez-le à jour !
Yes=Oui

; footer messages
Array Copying=Copie de la baie
Array Clearing=Nettoyage de la baie
Array Starting=Démarrage de la baie
Array Stopping=Arrêt de la baie
Mounting disks=Montage des disques
Spinning up all drives=Amorçage de tous les disques
Stale configuration=Configuration obsolète
Starting services=Démarrage des services
Stopping services=Arrêt des services
Starting Recycle Bin=Démarrage de la corbeille
Stopping Recycle Bin=Arrêt de la corbeille
Sync filesystems=Synchronisation des systèmes de fichiers
Unmounting disks=Démontage des disques
Autostart disabled=Démarrage automatique désactivé
Missing encryption key=Clé de cryptage manquante
Opening encrypted volumes=Ouverture des volumes chiffrés

; docker variables
Container Path=Chemin du conteneur
Container Port=Port du conteneur
Container Variable=Variable du conteneur
Container Label=Étiquette du conteneur
Container Device=Dispositif du conteneur

; Note: April 29, 2023 - 1 missing translations
Retry unmounting user shares=Retry unmounting user share(s)
